+------------------+
|       |          |
|--- +  |  -----+  |
|    |          |  |
| +  +------+   |  |
| |         |   |  |
| +---+     +---+  |
|     |            |
|--+  +------------|
|     |            |
|--+  |   +        |
|  |  |   |   +----|
|  |      |        |
|  +------+---+    |
|             |    |
|    +----+   +    |
|    |             |
| +--|   +---------|
|    |            O|
+------------------+