MMMMMMMMMMMMMJM
MSSSMMMMMMSSSSM
MMMSSSSSMMSMMMM
MMMMMMMSMMSSSMM
MSSSSSSSMMMMSMM
MSMMMMMMSSSMSSM
MSMMMSSMSMSMMSM
MSMMMSMMSMSSSSM
MSSSSSMMSMSMMMM
MMMSMSSSSMSMSMM
MMSSMMSMMMSSSMM
GSSMSMSMMMSMMMM
MMMMSMSMMMSMMMM
MMMMSSSSSSSMMMM
MMMMMMMMMMMMMMM
